###############
#O..#.#....O#.#
#.#.#.#.###...#
###.#...#...#.#
#.........#.#.#
#...##.##.#.#.# 
#. .#.D.#.#...#
#. .#DDD#.#.#.#
#...#####.#.#.#
#.....#...#.#.#
#..###P.#...#.#
#.......#.....#
#O.#.#..##..#.#
#######......O#
#score#########
