#############
#o..#.#....o#
#.#.#.#.###.#
###.#...#...#
#.........#.#
#...##.##.#.#
#...#.D.#.#.#
#...#DDD#.#.#
#...#####.#.#
#.....#...#.#
#..###P.#...#
#o......#o..#
#############
